###########################
#............R............#
#.####.######L######.####.#
#.####.#*#########*#.####.#
#.####..\#*******#\..####.#
#.######..\\\\\\\..######.#
#.####*######.######*####.#
#.####\.....#.#.....\####.#
#......####.#.#.####....#.#
#####.#***#.#.#.#***#.#.#.#
#......\\\..#.#..\\\..#.#.#
#.#########*****#####.#.#.#
#..........\\\\\......#...#
###########################

Water 7
Waterproof 42
Score 1414
